19 19 19 19 19 19 19 19 19 19 19 19 19 19 19 19 19 19 19 19 19 19 19 19 19 19 19 19 19 19 19 19 19 19 19 19 19 19 19 19 19 19 19 19 19 19 19 19 19 19 
19 19 19 19 19 19 19 19 19 19 19 19 19 19 19 19 19 19 19 19 19 19 19 19 19 19 19 19 19 19 19 19 19 19 19 19 19 19 19 19 19 19 19 19 19 19 19 19 19 19 
19 19 19 19 19 19 19 19 19 19 19 19 19 19 19 19 19 19 19 19 19 19 19 19 19 19 19 19 19 19 19 19 19 19 19 19 19 19 19 19 19 19 19 19 19 19 19 19 19 19 
19 19 19 19 19 19 19 19 19 19 19 19 19 19 19 19 19 19 19 19 19 19 19 19 19 19 19 19 19 19 19 19 19 19 19 19 19 19 19 19 19 19 19 19 19 19 19 19 19 19 
19 19 19 19 19 19 19 19 19 19 19 19 19 19 19 19 19 19 44 44 44 44 44 44 44 44 44 44 44 19 19 19 19 19 19 19 19 19 19 19 19 19 19 19 19 19 19 19 19 19 
19 19 19 19 19 19 19 19 19 19 19 19 19 44 44 44 44 44 44 45 43 45 43 45 43 43 43 45 44 44 44 44 44 44 19 19 19 19 19 19 19 19 19 19 19 19 19 19 19 19 
19 19 19 19 19 19 19 19 19 19 19 44 44 44 45 43 43 43 43 43 43 43 43 43 43 43 43 43 43 43 43 43 43 44 44 44 19 19 19 19 19 19 19 19 19 19 19 19 19 19 
19 19 19 19 19 19 19 19 19 19 44 44 45 43 43 43 43 43 43 43 43 61 43 43 72 43 43 43 43 43 43 43 43 43 43 44 44 19 19 19 19 19 19 19 19 19 19 19 19 19 
19 19 19 19 19 19 19 19 19 44 44 43 43 43 43 43 43 61 43 61 72 61 61 61 61 61 72 61 61 72 43 43 43 43 43 43 44 44 19 19 19 19 19 19 19 19 19 19 19 19 
19 19 19 19 19 19 19 19 19 44 43 43 43 43 43 72 72 72 61 61 61 61 61 67 61 61 61 61 61 61 61 61 43 43 43 43 43 44 19 19 19 19 19 19 19 19 19 19 19 19 
19 19 19 19 19 19 19 19 44 44 43 43 43 43 43 61 61 61 67 67 67 67 67 67 67 67 67 67 67 61 61 61 61 43 43 43 43 44 44 19 19 19 19 19 19 19 19 19 19 19 
19 19 19 19 19 19 19 19 44 43 43 43 61 61 61 61 67 67 67 67 67 67 67 67 67 67 67 67 67 67 67 61 61 61 61 43 43 43 44 19 19 19 19 19 19 19 19 19 19 19 
19 19 19 19 19 19 19 19 44 45 43 43 61 61 61 67 67 67 67 67 67 67 67 67 67 67 67 67 67 67 67 67 61 72 72 43 43 45 44 19 19 19 19 19 19 19 19 19 19 19 
19 19 19 19 19 19 19 19 44 43 43 43 72 61 67 67 67 67 67 67 67 67 67 67 67 67 67 67 67 67 67 67 67 61 61 61 43 43 44 19 19 19 19 19 19 19 19 19 19 19 
19 19 19 19 19 19 19 19 44 43 43 43 61 61 67 67 67 67 67 67 67 67 67 67 67 67 67 67 67 67 67 67 67 61 61 72 43 43 44 19 19 19 19 19 19 19 19 19 19 19 
19 19 19 19 19 19 19 19 44 43 43 72 61 67 67 67 67 67 67 67 67 67 67 67 67 67 67 67 67 67 67 67 67 67 61 43 43 43 44 19 19 19 19 19 19 19 19 19 19 19 
19 19 19 19 19 19 19 19 44 43 43 43 61 61 67 67 67 67 67 67 67 67 67 67 67 67 67 67 67 67 67 67 67 61 72 43 43 43 44 19 19 19 19 19 19 19 19 19 19 19 
19 19 19 19 19 19 19 19 44 43 43 72 61 61 67 67 67 67 67 67 67 67 67 67 67 67 67 67 67 67 67 67 67 61 61 61 43 43 44 19 19 19 19 19 19 19 19 19 19 19 
19 19 19 19 19 19 19 19 44 43 43 43 72 61 61 67 67 67 67 67 67 67 67 67 67 67 67 67 67 67 67 67 61 61 43 43 43 43 44 19 19 19 19 19 19 19 19 19 19 19 
19 19 19 19 19 19 19 19 44 43 43 43 61 61 61 61 67 67 67 67 67 67 67 67 67 67 67 67 67 67 67 61 61 61 72 43 43 45 44 19 19 19 19 19 19 19 19 19 19 19 
19 19 19 19 19 19 19 19 44 44 43 43 43 61 61 61 61 61 67 67 67 67 67 67 67 67 67 67 67 61 61 61 61 43 43 43 43 44 44 19 19 19 19 19 19 19 19 19 19 19 
19 19 19 19 19 19 19 19 19 44 43 43 43 43 72 61 61 61 61 61 61 61 61 67 61 61 61 61 61 61 72 72 43 43 43 43 43 44 19 19 19 19 19 19 19 19 19 19 19 19 
19 19 19 19 19 19 19 19 19 44 44 43 43 43 43 43 72 61 61 72 61 61 61 61 61 61 61 72 61 61 61 43 43 43 43 43 44 44 19 19 19 19 19 19 19 19 19 19 19 19 
19 19 19 19 19 19 19 19 19 19 44 44 43 43 43 43 43 43 43 43 43 72 72 72 61 43 43 43 43 43 43 43 43 43 43 44 44 19 19 19 19 19 19 19 19 19 19 19 19 19 
19 19 19 19 19 19 19 19 19 19 19 44 44 44 43 43 43 43 43 43 43 43 43 43 43 43 43 43 43 43 43 45 43 44 44 44 19 19 19 19 19 19 19 19 19 19 19 19 19 19 
19 19 19 19 19 19 19 19 19 19 19 19 19 44 44 44 44 44 44 45 43 45 43 43 45 43 43 45 44 44 44 44 44 44 19 19 19 19 19 19 19 19 19 19 19 19 19 19 19 19 
19 19 19 19 19 19 19 19 19 19 19 19 19 19 19 19 19 19 44 44 44 44 44 44 44 44 44 44 44 19 19 19 19 19 19 19 19 19 19 19 19 19 19 19 19 19 19 19 19 19 
19 19 19 19 19 19 19 19 19 19 19 19 19 19 19 19 19 19 19 19 19 19 19 19 19 19 19 19 19 19 19 19 19 19 19 19 19 19 19 19 19 19 19 19 19 19 19 19 19 19 
19 19 19 19 19 19 19 19 19 19 19 19 19 19 19 19 19 19 19 19 19 19 19 19 19 19 19 19 19 19 19 19 19 19 19 19 19 19 19 19 19 19 19 19 19 19 19 19 19 19 
19 19 19 19 19 19 19 19 19 19 19 19 19 19 19 19 19 19 19 19 19 19 19 19 19 19 19 19 19 19 19 19 19 19 19 19 19 19 19 19 19 19 19 19 19 19 19 19 19 19 
