0 0 0 0 0 0 0 0 0 0 0 0 0 0 0 0 0 0 0 0 0 0 0 0 0 0 0 0 0 0 17 17 17 17 18 18 18 18 18 18 17 18 18 19 20 21 21 20 20 20 
0 0 0 0 0 0 0 0 0 0 0 0 0 0 0 0 0 0 0 0 0 0 0 0 0 0 0 0 0 0 17 17 18 18 18 18 18 18 18 18 18 18 18 18 18 19 20 20 19 20 
0 0 0 0 0 0 0 0 0 0 0 0 0 0 0 0 0 0 0 0 0 0 0 0 0 0 0 0 0 0 17 17 18 18 18 18 19 18 18 19 19 19 19 19 20 20 19 21 20 20 
0 0 0 0 0 0 0 0 0 0 0 0 0 0 0 0 0 0 0 0 0 0 0 0 0 0 0 0 0 0 17 17 18 18 19 19 19 19 20 20 18 20 20 20 20 20 20 19 18 2 
0 0 0 0 0 0 0 0 0 0 0 0 0 0 0 0 0 0 0 0 0 0 0 0 0 0 0 0 0 0 17 17 18 18 19 20 20 20 20 20 20 20 21 20 20 20 21 20 20 18 
0 0 0 0 0 0 0 0 0 0 0 0 0 0 0 0 0 0 0 0 0 0 0 0 0 0 0 0 0 0 17 17 18 18 19 20 20 19 20 21 20 21 21 21 20 21 20 21 20 20 
17 17 0 17 17 17 17 17 17 17 17 17 17 17 17 17 17 17 17 17 0 0 0 0 0 0 0 0 0 0 17 17 18 18 19 20 19 21 21 21 19 19 21 20 20 21 21 21 19 20 
17 17 17 17 17 17 17 17 17 17 17 17 17 17 17 17 17 17 17 17 0 0 0 0 0 0 0 0 0 0 17 17 17 18 18 18 21 20 20 20 20 20 20 20 21 21 19 21 21 20 
17 17 17 18 17 18 18 18 18 17 18 18 18 18 18 17 18 18 17 17 0 0 0 0 0 0 0 0 0 0 17 17 18 18 18 19 21 20 21 21 20 21 2 21 21 20 20 19 20 20 
17 18 18 17 18 18 17 18 18 17 18 18 17 18 18 18 18 18 17 17 0 0 0 0 0 0 0 0 0 0 17 17 18 18 19 20 20 20 20 21 2 20 18 20 20 20 19 20 19 19 
17 18 17 18 18 18 18 19 19 18 19 19 18 19 19 19 18 18 17 17 0 0 0 0 0 0 0 0 0 0 17 0 18 18 19 20 20 20 21 21 20 21 20 20 21 21 20 18 19 18 
17 18 17 19 20 19 18 20 20 20 20 18 18 20 20 18 17 18 17 17 0 0 0 0 0 0 0 0 0 0 17 17 18 18 18 20 19 20 21 20 20 18 20 21 19 21 20 19 19 18 
17 18 18 18 20 20 21 20 20 20 20 20 20 20 20 18 18 18 17 17 0 0 0 0 0 0 0 0 0 0 17 17 18 18 18 19 20 21 21 21 21 19 20 19 21 21 20 19 19 18 
17 18 18 19 18 20 21 19 21 20 20 20 19 20 20 19 17 18 17 17 17 17 17 17 17 17 17 17 17 17 17 17 17 17 18 20 21 20 19 20 20 20 20 20 20 20 20 18 19 18 
17 18 18 17 18 21 21 19 20 21 21 21 20 21 18 19 18 18 17 17 17 17 17 17 17 17 17 17 17 17 17 17 18 18 18 20 20 20 19 20 18 20 20 20 20 20 19 19 18 18 
17 18 18 18 19 20 19 21 20 21 20 20 21 20 20 18 18 18 18 17 18 18 18 18 18 18 18 18 18 18 18 17 18 18 18 19 19 19 18 19 19 18 19 18 18 19 18 18 18 18 
17 18 18 19 19 20 21 21 18 2 19 21 20 21 20 19 18 18 18 18 17 18 18 18 18 18 18 18 18 18 17 17 18 18 18 18 18 18 18 18 18 18 18 18 18 18 18 18 18 18 
17 18 18 18 20 20 19 20 21 20 18 19 20 19 18 19 18 18 18 18 18 18 17 19 18 18 17 18 19 19 18 18 18 18 18 18 18 18 18 18 18 18 18 18 18 18 18 18 18 17 
17 18 18 18 20 18 21 18 20 20 21 20 20 20 20 19 18 19 20 18 20 20 19 20 20 19 20 20 19 19 17 17 17 17 17 17 17 17 17 17 17 17 17 17 17 17 17 17 17 17 
17 18 18 17 20 20 21 20 21 21 20 20 20 20 20 19 18 19 20 19 19 20 19 20 21 21 19 19 20 19 18 18 17 17 17 17 17 17 17 17 17 17 17 17 17 17 17 17 17 17 
17 18 18 18 20 20 20 20 19 19 20 21 21 20 19 18 18 18 20 20 21 18 19 20 21 20 20 21 20 19 18 18 17 17 0 0 0 0 0 0 0 0 0 0 0 0 0 0 0 0 
17 18 18 18 19 20 20 19 20 20 17 20 20 20 20 19 17 18 18 21 20 19 19 20 20 20 20 20 20 19 18 18 17 17 0 0 0 0 0 0 0 0 0 0 0 0 0 0 0 0 
17 18 18 19 19 19 19 17 19 19 18 18 19 18 19 18 18 18 17 21 20 19 20 21 20 21 20 18 20 18 18 18 17 17 0 0 0 0 0 0 0 0 0 0 0 0 0 0 0 0 
17 18 18 18 18 18 18 18 18 18 18 18 18 18 18 18 18 18 18 21 19 21 20 2 17 18 20 21 20 18 18 18 17 17 0 0 0 0 0 0 0 0 0 0 0 0 0 0 0 0 
17 18 18 18 18 18 18 18 18 18 17 0 18 18 17 18 18 18 19 20 20 20 20 18 19 20 20 20 20 19 17 18 17 17 0 0 0 0 0 0 0 0 0 0 0 0 0 0 0 0 
17 17 17 17 17 17 17 17 17 17 17 17 17 17 17 18 17 18 20 20 20 20 19 20 19 20 20 21 19 17 18 18 17 17 0 0 0 0 0 0 0 0 0 0 0 0 0 0 0 0 
17 17 17 17 17 17 17 17 17 17 17 17 17 17 17 18 18 18 19 20 20 21 20 21 20 21 20 20 20 19 17 18 17 17 0 0 0 0 0 0 0 0 0 0 0 0 0 0 0 0 
0 0 0 0 0 0 0 0 0 0 0 0 0 17 17 18 18 18 18 21 21 19 20 19 18 20 20 20 20 19 18 18 17 17 0 0 0 0 0 0 0 0 0 0 0 0 0 0 0 0 
0 0 0 0 0 0 0 0 0 0 0 0 0 17 17 18 18 18 20 20 19 20 20 19 19 20 20 19 20 19 18 18 17 17 0 0 0 0 0 0 0 0 0 0 0 0 0 0 0 0 
0 0 0 0 0 0 0 0 0 0 0 0 0 17 17 18 18 19 18 18 19 19 18 19 19 19 19 18 19 19 18 18 17 17 0 0 0 0 0 0 0 0 0 0 0 0 0 0 0 0 
